R 700 700

C 255, 255, 255
F 0, 0, 0

WE ./textures/walls/pb_bloobs.xpm
EA ./textures/walls/light_pb.xpm
NO ./textures/walls/dark_pb.xpm
SO ./textures/walls/pb_window.xpm
S ./textures/sprites/pillar.xpm

        11111111
        1000000111111111111111
        1000000100000000000001
        1002000100000002000001
        1000000100000000000001
111111111111011100000000000001
100000000000000000000111111111
10000000000000000000000000001
10000000000000000000002000001
11110111110020000000000000001
10000000000000000S00000000001
10000000010000010000011111111
10000000010000010000000000001111
10000000010000010000000000000001
11111111111111111111111111111111
