R 1000 10000

C 200, 0, 100
F 0, 255, 0

WE ./textures/candy_mushroom.xpm
EA ./textures/candy_mushroom.xpm
NO ./textures/candy_mushroom.xpm
SO ./textures/candy_mushroom.xpm
S ./textures/sprites/pillar.xpm

        11111111
        1000000111111111111111111111111
        1000000100000000000001000000001
        1000000100000000000000000000001
        1000000100000000000001000000001
111111111111011100000000000001000000001
100000000000000000000111111111100111111
100000000001000000000000000010000001
100000000010000000000020000011000111
111101111100200000000000000011100001
10000000000000000S000000000011000001
110000000100100100000111111111110111
1100000001001001000000000000111101111
1101010101001001000000000000000000001
1111111111111111111111111111111111111
