R 1280 720

C 0, 0, 51
F 221, 187, 68

WE ./textures/walls/lemmings_1.XPM
EA ./textures/walls/lemmings_2.XPM
NO ./textures/walls/lemmings_1.XPM
SO ./textures/walls/lemmings_4.XPM
S ./textures/sprites/lemmings.XPM

11111111111111111111111
10100010000100010000111
11011100000000000200111
10000000011111000000011
11000000001100000001111
10000000000100000111111
11000000000000000000011
1000000000N000000000001
11000000000000000000111
11100000000110000011111
11000000001110000000111
11111111111111111111111

