R 1280 720

C 92, 148, 252
F 128, 208, 15

WE ./textures/walls/mario_1.XPM
EA ./textures/walls/mario_4.XPM
NO ./textures/walls/mario_2.XPM
SO ./textures/walls/mario_3.XPM
S ./textures/sprites/mario.XPM

11111111111111111111111
100S0010000100010000111
11000000000000000000111
10000000011111000000011
10020000000000000001111
10000010000000000111111
11100011000100000000011
10000011000100002000001
11000001000100000000111
11000020010110200011111
11011000001110002000111
11111111111111111111111

