R 1000 10000

C 123, 246, 18
F 20, 116, 0

WE ./textures/matrix_green.xpm
EA ./textures/matrix_green.xpm
NO ./textures/matrix_green.xpm
SO ./textures/matrix_green.xpm
S ./textures/pillar.xpm

111111111111
100000000001
100000S00001
100000000001
111011110111
100001100001
100001100001
100201100201
100001100001
100011110001
100111111001
101111111101
100000000001
111111111111
