R 1280 720

C 200, 200, 200
F 0, 0, 0

WE ./textures/dark_pb.xpm
EA ./textures/dark_pb.xpm
NO ./textures/dark_pb.xpm
SO ./textures/dark_pb.xpm

111111111111111111111111111111
100000001000000000010000010001
1000S0001000000000010000010501
1000000010000000000110201107011
110000011000000000010000010000111111
111000111000000000011100111191100001
111101111000000000010000011001100001
111000111111111000011191103011104001
111000111111110000010070100001100001
111101111111000000010000100011119111
1111011111111111r111g1111b1110000001
111000111111110000000000000010006001
  1000001100000000000000000011100001
  1111100001000000000000000700000001
  1111111111000000000000000001111111
          111111000000000000111
              1111000000001111
                111111111111