R 1000 1000

C 255, 255, 255
F 0, 0, 0

SO ./textures/light_pb.xpm
EA ./textures/dark_pb.xpm
NO ./textures/light_pb.xpm
WE ./textures/dark_pb.xpm
S ./path_to_the_sprite_texture

        11111111
        1000000111111111111111111111111
        1000000100000000000001000000001
        1000000100000000000003000000001
        1000000100000000000001000000001
111111111111311100000000000001000000001
100000000000000000000111111111111113111
10000000000000000000000000001     101
1000000000000000000000W000001     101
11113111110000000000000000001     101
10000000030000000000000000001     101
10000000010000010000011111111     101
1000000001000001000000000000111111101
1000000001000001000000000000300000001
1111111111111111111111111111111111111