R 1280 720

C 200, 200, 200
F 0, 0, 0

WE ./textures/pixel_walls.XPM
EA ./textures/pixel_walls.XPM
NO ./textures/pixel_walls.XPM
SO ./textures/pixel_walls.XPM

        11111111
        1000000111111111111111111111111
        1000000100000S00000001000000001
        1000000r00000000000009000000001
        1000000100000000000001000000001
111111111b1191110000000000000g000000001
100000000000000000000000000011111119111
10002000300400500600000000001     101
10000000000000000000000000001     101
10000000000000000000000000001     101
10000000000000000000000000001     101
10000000000000011r11g111b1911     101
1000000000000001000000000000111111101
1000000000000001000000000000900000001
1000000001111111111111111111111111111
1111111111111111111111111111111111111

