R 640 640

C 0, 100, 230
F 255, 50, 230

SO ./path_to_the_south_texture
EA ./path_to_the_east_texture
NO ./path_to_the_north_texture
WE ./path_to_the_west_texture
S ./path_to_the_sprite_texture


1111111111
100S000001
1100000111
1000000001
1110000001
1111011111
1110000101
1100000001
1101011101
1111111111