R 600 500

F 220, 100, 255
C 225, 30, 0

SO ./path_to_the_south_texture
EA ./path_to_the_east_texture
NO ./path_to_the_north_texture
WE ./path_to_the_west_texture
S ./path_to_the_sprite_texture

        1111111111111111111111111
        1000000000110000000000001
        1011000001110000002000001
        1001000000000000000000001
111111111011000001110000000000001
100000000011000001110111111111111
11110111111111011100000010001
11110111111111011101010010001
110000001101010111000000100011
100020000000000011000001000001
100000000000000011010100100011
1100000111010101111101111000111
1N110111 1110101 101111010001
11111111 1111111 111111111111