R 640 640

C 0, 55, 200
F 255, 55, 200

SO ./path_to_the_south_texture
EA ./path_to_the_east_texture
NO ./path_to_the_north_texture
WE ./path_to_the_west_texture
S ./path_to_the_sprite_texture


11111111111111111111
10000110000000000001
10110000011100000001
10010000000000000001
11111111101100000111
10000000001100000011
11110111111110000001
11110111111110000101
11000000110101011101
1000S000000000001101
10000000000000001101
11000000000101011101
11110111000101010001
11111111000111111111
10000110000000000001
10110000011100000001
10010000000000000001
11111111101100000111
10000000001100000011
11110111111110000001
11110111111110000101
11000000110101011101
10000000000000001101
10000000000000001101
11000000000101011101
11110111000101010001
11111111111111111111