R 1920 1080

C 0, 100, 230
F 255, 50, 230

SO ./path_to_the_south_texture
EA ./path_to_the_east_texture
NO ./path_to_the_north_texture
WE ./path_to_the_west_texture
S ./path_to_the_sprite_texture


        1111111111111111111111111
        1000000100000000000000001
        1000000100000000000000001
        1000000100000000000000001
111111111000000100000000000000001
100000000000000000000111111111111
10000000000000000000000000001
1000000000000000000000W000001
11111111000000000000000000001
10000000000000000000000000001
10000000000000010000011111111
10000000010000010000000000001
10000000010000010000000000001
11111111111111111111111111111