R 1000 500

C 0, 55, 200
F 255, 55, 200

SO ./path_to_the_south_texture
EA ./path_to_the_east_texture
NO ./path_to_the_north_texture
WE ./path_to_the_west_texture
S ./path_to_the_sprite_texture


111111111111111111111111111111111
1E0000001000000000110000000000001
111110001001011111110000002000101
    10000001000000000000000000101
111111111001000001110000000000101
100000000000000001110111111111101
111100111101110111000000000011101
111100111101000000011110100000001
100000000101000000011100100000001
101111210000010000001100100000001
101110010000010111101100100000001
101110011101110111101111100011111
1000000000000001 110000000001
1111111111111111 111111111111