R 1280 720

C 150, 150, 150
F 0, 0, 0

WE ./textures/tile_64.XPM
EA ./textures/matrix_green.xpm
NO ./textures/candy_mushroom.xpm
SO ./textures/pb_bloobs.xpm
S ./textures/pillar.xpm

        11111111
        1000000111111111111111111111111
        1200000100000200000001000000201
        1000000100000000000003000000001
        1000000100000000000001000000001
111111111111311100000000000001000000001
100000000000000000002111111111111113111
10200000W00000000000000000001     101
10000000000000000000000000001     101
11113111110000000000000002001     101
10000000030000000000000000001     101
10002000010000010020011111111     101
1000000001000001000000000000111111101
1000000001020001000000000000300000001
1111111111111111111111111111111111111