R 1280 720

C 150, 150, 150
F 0, 0, 0

WE ./textures/tile_64.XPM
EA ./textures/light_pb.xpm
NO ./textures/dark_pb.xpm
SO ./textures/matrix_green.xpm
S ./textures/pillar.xpm

        11111111
        1000000111111111111111111111111
        1000000100000000000001000000001
        1000000100000000000003000000001
        1000000100000000000001000000001
111111111111311100000000000001000000001
100000000000000000000111111111111113111
10000000000000000000000000001     101
10000000000000000000002000001     101
11113111110020000000000000001     101
10000000030000000S00000000001     101
10000000010000010000011111111     101
1000000001000001000000000000111111101
1000000001000001000000000000300000001
1111111111111111111111111111111111111

