R 1280 720

C 200, 200, 200
F 0, 0, 0

WE ./textures/tile_64.XPM
EA ./textures/light_pb.xpm
NO ./textures/dark_pb.xpm
SO ./textures/matrix_green.xpm

111111111111111111111111111111111111111
111111111111111110001111111111111111111
111111111111111110001111111111111111111
111111111111111110001111111111111111111
111111111111111110001111111111111111111
111111111111111110001111111111111111111
111111111111111110001111111111111111111
111111111111111110001111111111111111111
111111111111111110001111111111111111111
111111111111111110001111111111111111111
111111111111111110001111111111111111111
111111111111111110001111111111111111111
111111111111111110001111111111111111111
111111111111111110001111111111111111111
111111111111111110001111111111111111111
111111111111111111011111111111111111111
111111111111111110001111111111111111111
111111111111111110001111111111111111111
111111111111111110001111111111111111111
111111111111111110001111111111111111111
111111111111111110001111111111111111111
111111111111111110001111111111111111111
111111111111111111011111111111111111111
111111111111111110001111111111111111111
111111111111111110001111111111111111111
111111111111111110001111111111111111111
111111111111111110001111111111111111111
111111111111111110001111111111111111111
111111111111111110001111111111111111111
111111111111111110001111111111111111111
111111111111111110001111111111111111111
111111111000000001S10000000001111111111
111111111000000000000000000001111111111
111111111000000000000000000001111111111
111111111000000000000000000001111111111
111111111000000000000000000001111111111
111111111000000000000000000001111111111
111111111000000000000000000001111111111
111111111000000000000000000001111111111
111111111000000000000000000001111111111
111111111000000000000000000001111111111
111111111200000000000000000021111111111
111111111900000000000000000091111111111
111111111200203040506070809021111111111
111111111111111111111111111111111111111
111111111100000000011111111111111111111
111111111101111111111111111111111111111
111111111101000000000000000111111111111
111111111101000000000000000111111111111
111111111101000000000000000111111111111
111111111101000000000000000111111111111
111111111101000000000000000111111111111
111111111101000000000000000111111111111
111111111101111111311111111111111111111
111111111100000000000000000000000000001
111111111111111111111111111111111111111