R 1280 720

C 200, 200, 200
F 0, 0, 0

WE ./textures/pixel_walls.XPM
EA ./textures/pixel_walls.XPM
NO ./textures/pixel_walls.XPM
SO ./textures/pixel_walls.XPM


1111111111       11111
1000000001       10001111111111111111
1000300001       11411000000000000001111111111
1111011111       100010000000000000011100000011
   101           1000s00000000000000110000000011
 111s1111111     11111000000050000001000000000011
 10000000001         10000001010000010000000000011
 1000000000111111111111111111011111110000000000001
 1000000000100000000000000001010000000000000000001
 1000000000s00000000000000001g10000000000000000011
 10000800001000000000000W000101000000000900000011
 10000001111000000000111111110111110000000000001
 111116111 1100000000000000000000110000000000001
    11001111111111111111100000000111111100111111
    1000000000000000000010000000000r0000001
    111111111111100000000000000001111111111
                11111111111100000111111
                           111011100001
                             1010000001
                             1b100200011111
                             10110000111101
                             1000800s007001
                             11100011111111
                             11111111111111