L 1

C 200, 0, 0
F 5, 5, 255

WE ./textures/walls/pixel_walls.XPM
EA ./textures/walls/pixel_walls.XPM
NO ./textures/walls/pixel_walls.XPM
SO ./textures/walls/pixel_walls.XPM


1111111111       11111
1000000001       10001111111111111111
1000300001       11411000000000000001111111111
1111011111       100010000000000000011100000011
   101           1000s00000000000000110000000011
 111s1111111     11111000000050000001000000000011
 10000000001         10000001010000010000000000011
 1000800000111111111111111111011111110000000000001
 1000000000s00000000000000001010000000000000000001
 1000000000100000000000000W01g10000000000000000011
 100008000010000000000000000101000000000900000011
 10000001111000000000111111110111110000000100001
 111116111 1100000000000000000000110000000100001
    11001111111111111111100000000111111100111111
    1000000000000000000010000000000r0000001
    111111111111100000000000000001111111111
                111111111111000001111110001
                           1110111000100001
                             10100070s00001
                             1b100000100201
                             10111111110001
                             10000000000011
                             11111111111111