L 2

C 150, 0, 200
F 0, 0, 100

WE ./textures/pixel_walls.XPM
EA ./textures/pixel_walls.XPM
NO ./textures/pixel_walls.XPM
SO ./textures/pixel_walls.XPM


11111111111111111111111111111111111111
1E000000000000000000000000000000000001    111111111111
111111011111111111111011111111111111011111100000000001
111100000000010000000000000000100000010000000000009001
100000111110011111101111111110111101110110000000000001
100111111111011111101111100000111100018110000000000001
101111110000000000101111101111100000110110111111111001
100011100111111110100011100011110111110110111111111001
100000000011111110111010000000000000118110000000000001
111101111111111100100010111111111100110111111111111111
11000111111110000010111011111111111011011
11011111111110111110111000011111000011811
11011111111110111110111110011111110011011
10000000000000000000000000000000000000011
11111111111111111111111111111111111111111