R 1280 720

C 75, 6, 159
F 28, 209, 222

WE ./textures/pixel_walls.XPM
EA ./textures/pixel_walls.XPM
NO ./textures/pixel_walls.XPM
SO ./textures/pixel_walls.XPM

111111111111111111111111111111
100000001000000000010000010001111111
1000S0001000000000010000010501000001
100000001000000001011020110701100401
110000011000000110010000010000100001
1110001110000001000111001111911119111
1111011110000001000100000110011000001
1110001111111110000111911030110000001
1110001111111100000100001000100000001
1111011111110000000100001000100000001
1111011111111111011111111111100000001
1110001111111100000000000000100060011
  1000001111110000000001110000111111111
  1111100000011111110000100000700000001
  1111111111000000100000100001111111111
          111111000110111000111
              1111000000001111
                111111111111