R 1280 720

C 200, 200, 200
F 0, 0, 0

WE ./textures/pixel_walls.XPM
EA ./textures/pixel_walls.XPM
NO ./textures/pixel_walls.XPM
SO ./textures/pixel_walls.XPM


                111111111111111111111
                100000S0000011g1001
                1000000000001101001
                100000000000110111111
                100000000000000001001
                100000000000000001111
                1000000000000000000r1
                100000000000000001111
                100000000000100001001
                100000000000110111111
                1000000000001101001
                10000000000011b100111
                100000000000100000001
                100000000000100000001
                110101011100100000001
                1101010111011060111111
                11r1g1b111b110001
                10001000100010011
                1000100010001001
                1000000011011001
                1000000001001001
                1000000001000001
                1111111111111111