R 1280 720

C 200, 0, 0
F 5, 5, 255

WE ./textures/pixel_walls.XPM
EA ./textures/pixel_walls.XPM
NO ./textures/pixel_walls.XPM
SO ./textures/pixel_walls.XPM

111111111111111111111111111111
100000001000000000010000010001111111
1000S0001000000000010000010501000001
100000001000009000011020110701100401
110000011000000000010000010000100001
1110001110000000000111001111s1111s111
1111011110000000000100000110011000001
1110001111111110000111s11030110000001
1110001111111100000100001000100000001
1111011111110000000100001000100000001
1111011111111111r111g1111b11100000001
1110001111111100080000000000100060011
  1000001100000002003004000011100001
  1111100001000000000060000700070001
  1111111111000000800000000001111111
          111111000000500800111
              1111008000001111
                111111111111